1 1 1 1 1 1 1 1 1 1 1 1 1 1 1 1 1 1 1 1
0 0 0 0 0 0 5 5 5 5 5 0 0 0 0 0 0 0 0 0
0 0 0 0 0 5 5 5 5 5 5 5 5 5 0 0 0 0 0 0
0 0 0 0 0 3 3 3 6 6 0 6 0 0 0 0 0 0 0 0
0 0 0 0 3 6 3 6 6 6 0 6 6 6 0 0 0 0 0 0
0 0 0 0 3 6 3 3 6 6 6 3 6 6 6 0 0 0 0 0
0 0 0 0 3 3 6 6 6 6 3 3 3 3 0 0 0 0 0 0
0 0 0 0 0 0 6 6 6 6 6 6 6 0 0 0 0 0 0 0
0 0 0 0 0 2 2 5 2 2 2 0 0 0 0 0 0 0 0 0
0 0 0 0 2 2 2 5 2 2 5 2 2 2 0 0 0 0 0 0
0 0 0 2 2 2 2 5 5 5 5 2 2 2 2 0 0 0 0 0
0 0 0 6 6 2 5 6 5 5 6 5 2 6 6 0 0 0 0 0
0 0 0 6 6 6 5 5 5 5 5 5 6 6 6 0 0 0 0 0
0 0 0 6 6 5 5 5 5 5 5 5 5 6 6 0 0 0 0 0
0 0 0 0 0 5 5 5 0 0 5 5 5 0 0 0 0 0 0 0
0 0 0 0 2 2 2 0 0 0 0 2 2 2 0 0 0 0 0 0
0 0 0 2 2 2 2 0 0 0 0 2 2 2 2 0 0 0 0 0
0 0 0 0 0 0 0 0 0 0 0 0 0 0 0 0 0 0 0 0
0 0 0 0 0 0 0 0 0 0 0 0 0 0 0 0 0 0 0 0
0 0 0 0 0 0 0 0 0 0 0 0 0 0 0 0 0 0 0 0
0 0 0 0 0 0 0 0 0 0 0 0 0 0 0 0 0 0 0 0
0 0 0 0 0 0 0 0 0 0 0 0 0 0 0 0 0 0 0 0
0 0 0 0 0 0 0 0 0 0 0 0 0 0 0 0 0 0 0 0
0 0 0 0 0 0 0 0 0 0 0 0 0 0 0 0 0 0 0 0
0 0 0 0 0 0 0 0 0 0 0 0 0 0 0 0 0 0 0 0
0 0 0 0 0 0 0 0 0 0 0 0 0 0 0 0 0 0 0 0
0 0 0 0 0 0 0 0 0 0 0 0 0 0 0 0 0 0 0 0
0 0 0 0 0 0 0 0 0 0 0 0 0 0 0 0 0 0 0 0
0 0 0 0 0 0 0 0 0 0 0 0 0 0 0 0 0 0 0 0
0 0 0 0 0 0 0 0 0 0 0 0 0 0 0 0 0 0 0 0