1 1 1 1 1 1 1 1 1 1 1 1 1 1 1 1 1 1 1 1
0 0 0 0 0 0 0 0 0 0 0 0 0 0 0 0 0 0 0 0
0 0 0 0 0 0 5 5 5 5 5 0 0 0 0 0 0 0 0 0
0 0 0 0 0 5 5 5 5 5 5 5 5 5 0 0 0 0 0 0
0 0 0 0 0 3 3 3 2 2 0 2 0 0 0 0 0 0 0 0
0 0 0 0 3 2 3 2 2 2 0 2 2 2 0 0 0 0 0 0
0 0 0 0 3 2 3 3 2 2 2 3 2 2 2 0 0 0 0 0
0 0 0 0 3 3 2 2 2 2 3 3 3 3 0 0 0 0 0 0
0 0 0 0 0 0 2 2 2 2 2 2 2 0 0 0 0 0 0 0
0 0 0 0 0 7 7 5 7 7 7 0 0 0 0 0 0 0 0 0
0 0 0 0 7 7 7 5 7 7 5 7 7 7 0 0 0 0 0 0
0 0 0 7 7 7 7 5 5 5 5 7 7 7 7 0 0 0 0 0
0 0 0 2 2 7 5 2 5 5 2 5 7 2 2 0 0 0 0 0
0 0 0 2 2 2 5 5 5 5 5 5 2 2 2 0 0 0 0 0
0 0 0 2 2 5 5 5 5 5 5 5 5 2 2 0 0 0 0 0
0 0 0 0 0 5 5 5 0 0 5 5 5 0 0 0 0 0 0 0
0 0 0 0 7 7 7 0 0 0 0 7 7 7 0 0 0 0 0 0
0 0 0 7 7 7 7 0 0 0 0 7 7 7 7 0 0 0 0 0
0 0 0 0 0 0 0 0 0 0 0 0 0 0 0 0 0 0 0 0
0 0 0 0 0 0 0 0 0 0 0 0 0 0 0 0 0 0 0 0
0 0 0 0 0 0 0 0 0 0 0 0 0 0 0 0 0 0 0 0
0 0 0 0 0 0 0 0 0 0 0 0 0 0 0 0 0 0 0 0
0 0 0 0 0 0 0 0 0 0 0 0 0 0 0 0 0 0 0 0
0 0 0 0 0 0 0 0 0 0 0 0 0 0 0 0 0 0 0 0
0 0 0 0 0 0 0 0 0 0 0 0 0 0 0 0 0 0 0 0
0 0 0 0 0 0 0 0 0 0 0 0 0 0 0 0 0 0 0 0
0 0 0 0 0 0 0 0 0 0 0 0 0 0 0 0 0 0 0 0
0 0 0 0 0 0 0 0 0 0 0 0 0 0 0 0 0 0 0 0
0 0 0 0 0 0 0 0 0 0 0 0 0 0 0 0 0 0 0 0
0 0 0 0 0 0 0 0 0 0 0 0 0 0 0 0 0 0 0 0